11 25
0  0  0  0  0  0  0  0  0  0  0  0  0  0  0  0  0  0  0  0  0  0  0  0  0
0  0  0  0  0  0  0  0  0  0  0  0  0  0  0  0  0  0  0  0  0  0  0  0  0
0  0  0  0  0  0  0  0  0  0  0  0  0  0  0  0  0  0  0  0  0  0  0  0  0
0  0  0  0  0  0  0  0  0  0  0  0  0  0  0  0  0  0  0  0  0  0  0  0  0
0  0  0  8  0  9  0  0  0  0  0  0  0  0  0  0  0  0  0  0  0  0  0  0  0
0  1  1  1  1  1  1  1  0  0  0  0  5  0  0  0  0  0  0  0  0  0  0  0  0
0  0  0  0  0  0  0  0  0  0  0  0  0  0  0  0  0  0  0  0  0  0  0  0  0
0  0  0  0  0  0  0  0  0  0  0  71 0  0  0  0  0  0  0  0  11 0  0  0  0
0  0  0  0  0  0  0  0  0  0  0  1  1  0  0  0  0  6  0  0  0  0  0  0  0
0  0  0  81 0  0  0  0  0  0  0  1  1  0  0  0  0  0  0  0  0  0  0  0  0
1  1  1  1  1  1  1  1  0  0  1  1  1  1  1  2  3  1  1  1  1  1  1  1  1