24 29
0   0  0  0  0  0   0  0  0  0  0  0  0  0     0  0  0  0  0    0  0  0  0  0  0  0  0  0   0  
0   0  0  0  0  0   0  0  0  0  0  0  0  0     0  0  0  0  0    0  0  0  0  0  0  0  0  0   0  
0   8  9  0  0  0   82 0  0  0  0  0  6  0     5  0  0  0  0    0  0  0  82 0  0  0  0  0   0  
1   1  1  1  1  1   1  1  1  1  1  0  0  0     0  0  1  1  1    1  1  1  1  1  0  0  0  0   0  
0   0  0  0  0  0   0  0  0  0  0  0  0  0     0  0  0  0  2205 0  0  0  0  1  1  0  0  0   0  
0   0  0  0  0  0   0  0  0  0  0  0  0  0     0  0  0  0  0    0  0  0  0  1  1  1  0  0   0  
0   0  0  0  0  0   0  0  0  0  0  0  0  0     0  0  0  0  0    0  0  0  0  0  0  1  1  0   0  
0   0  0  0  0  0   0  0  0  0  0  0  0  0     0  0  0  0  0    0  0  0  0  0  0  0  0  0   0  
0   0  0  0  0  0   0  0  0  0  0  0  0  0     0  0  0  0  0    0  0  0  0  0  0  0  0  0   0  
0   0  0  0  0  300 0  0  0  0  0  0  6  0     5  0  0  0  300  0  0  0  0  0  0  0  0  1   1  
0   0  0  0  0  0   0  0  0  0  0  1  1  1     1  1  0  0  0    0  0  0  0  0  0  0  0  1   1  
0   0  0  0  4  4   4  4  4  4  4  1  1  1     1  1  4  4  4    4  4  4  4  0  0  1  1  1   1  
0   0  1  1  1  1   1  1  1  1  1  1  1  1     1  1  1  1  1    1  1  1  1  1  1  1  1  1   1
0   0  0  0  0  0   0  0  0  0  0  0  0  1103  0  0  0  0  0    0  0  0  0  0  0  0  0  0   0
0   0  0  0  0  0   0  0  0  0  0  0  0  0     0  0  0  0  0    0  0  0  0  0  0  0  0  0   0
1   1  0  0  0  0   0  81 0  0  0  0  0  0     0  0  0  81 0    0  0  0  0  0  0  0  0  0   0  
1   1  1  1  1  1   1  1  1  1  1  1  1  1     1  1  1  1  1    1  1  1  1  1  0  0  0  0   0
0   0  0  0  0  0   0  0  0  0  0  0  0  0     0  0  0  0  0    0  0  0  0  0  0  0  0  0   0  
0   0  0  0  5  0   5  0  0  0  0  0  0  0     0  0  0  0  5    0  5  0  0  0  0  0  0  0   0  
0   0  0  3  3  3   3  3  0  0  0  0  0  0     0  0  0  3  3    3  3  3  0  0  0  0  1  1   1  
0   0  0  1  1  1   1  1  0  0  0 300 0  0     0  0  0  1  1    1  1  1  0  0  0  0  1  1   1
0   0  0  0  6  0   6  0  0  0  0  0  0  0     0  0  0  0  6    0  6  0  0  0  0  1  1  1   1
0   0  0  2  2  2   2  2  0  82 0  0  0  0     0  0  0  2  2    2  2  2  0  0  0  1  1  1   1
1   1  1  1  1  1   1  1  1  1  1  1  1  1     1  1  1  1  1    1  1  1  1  1  1  1  1  1   1