19 29
0   0  0  0  0  0   0  0  0  0  0  0  0  0  0  0  0  0  0  0  0  0  0  0  0  0  0  0   0  
0   0  0  0  0  0   0  0  0  0  0  0  8  9  0  0  0  0  0  0  0  0  0  0  0  0  0  0   0  
1   1  1  1  1  1   1  1  1  1  1  1  1  1  1  1  1  1  1  1  1  1  1  1  1  1  1  0   0
0   0  0  0  0  0   0  0  0  0  0  0  0  0  0  0  0  0  0  0  0  0  1  1  1  1  1  121 0  
0   0  0  0  0  0   0  0  0  0  0  0  0  0  0  0  0  0  0  0  0  0  0  0  0  0  0  0   0  
0   0  0  0  0  0   82 0  0  0  0  0  0  0  0  0  0  0  0  0  0  0  0  0  0  0  0  0   0  
111 0  1  1  1  1   1  1  1  1  0  0  0  0  0  0  0  0  0  0  0  0  0  0  0  0  0  0   0
0   0  0  0  0  0   0  0  0  1  1  1  1  1  1  1  1  1  1  1  1  1  1  1  1  1  1  1   1
0   0  0  0  0  0   0  0  0  0  0  0  0  0  0  0  0  0  0  0  0  0  0  1  1  1  1  1   1
0   0  0  0  0  0   0  0  0  0  0  0  0  0  0  0  0  0  0  0  0  0  0  0  0  1  1  1   1  
0   0  0  0  0  711 0  0  0  0  0  0  0  0  0  0  0  0  0  0  0  0  0  0  0  0  0  1   1
1   1  1  1  1  1   1  1  1  1  0  0  0  0  0  0  0  0  0  0  0  0  0  0  0  0  0  0   0
0   0  0  0  0  0   0  0  1  1  1  0  0  0  0  0  0  0  0  0  0  0  0  0  0  0  0  0   0
0   0  0  0  0  0   0  0  0  1  1  1  1  1  1  1  1  4  4  4  1  1  1  1  1  0  0  0   0
0   0  0  0  0  0   0  0  0  0  0  0  0  0  0  0  0  0  0  0  0  0  0  0  0  0  0  0   0  
1   1  1  1  1  1   0  0  0  0  0  0  0  0  0  0  0  0  0  0  0  0  0  0  0  0  0  0   0
0   0  0  0  0  0   0  0  0  0  0  0  0  0  0  0  0  0  0  0  0  0  0  0  0  0  1  1   1
0   0  0  0  0  0   0  0  0  0  0  0  0  0  0  0  0  0  0  0  0  0  0  0  0  1  1  1   1
1   1  1  1  1  1   1  1  1  1  1  1  1  2  2  2  1  1  1  1  3  3  3  1  1  1  1  1   1