24 29
0   0  0  0  0  0   0  0  0  0  0  0  0  0  0  0  0  0  0  0  0  0  0  0  0  0  0  0   0  
0   0  0  0  0  0   0  0  0  0  0  0  0  0  0  0  0  0  0  0  0  0  0  0  0  0  0  0   0  
0   0  0  0  0  0   0  6  0  0  0  0  0  0  0  0  0  5  0  0  0  0  0  0  0  0  9  0   0  
0   0  0  0  0  1   1  1  1  1  1  1  1  1  1  1  1  1  1  1  1  1  1  1  1  1  1  1   1  
0   5  0  0  0  0   1  1  1  1  0  0  0  0  0  0  0  0  0  0  0  0  0  0  0  0  0  0   0  
1   1  1  0  0  0   0  0  0  0  0  0  0  0  0  0  0  0  7  0  0  0  0  0  0  0  0  0   0  
1   1  1  0  0  0   0  0  0  0  0  0  0  0  0  0  1  1  1  1  1  1  0  0  0  82 0  0   0  
1   1  1  1  1  1   1  1  1  1  1  1  1  1  1  1  1  1  1  1  1  1  1  1  1  1  1  0   0
0   0  0  0  0  0   0  0  0  0  0  0  0  0  0  0  0  0  0  0  0  0  0  0  0  0  0  121 0  
0   0  0  0  0  0   0  0  0  0  0  0  0  0  0  0  0  0  0  0  0  0  0  0  0  0  0  0   0  
0   0  0  6  0  0   82 0  0  0  0  0  0  0  0  0  0  0  0  0  0  0  0  0  0  0  0  0   0  
111 0  1  1  1  1   1  1  1  1  0  0  0  0  0  5  0  0  0  0  0  0  0  0  0  0  0  0   0
0   0  0  0  0  0   0  0  0  1  1  1  1  1  1  1  1  1  1  1  1  1  1  1  1  1  1  1   1
0   0  0  0  0  0   0  0  0  0  0  0  0  0  0  0  0  0  0  0  0  0  0  1  1  1  1  1   1
0   0  0  0  0  0   0  0  0  0  0  0  0  0  0  0  0  0  0  0  0  0  0  0  0  1  1  1   1  
0   0  0  0  0  0   0  0  0  0  0  0  0  0  0  0  0  0  0  0  0  0  0  0  0  0  0  0   0  
0   0  0  0  0  0   0  0  0  0  0  0  0  0  0  0  0  0  0  0  0  0  0  0  0  0  0  0   0  
0   0  0  0  0  0   0  0  0  0  0  0  0  0  0  0  0  0  0  0  0  0  0  0  0  0  0  0   0  
0   0  0  0  0  0   0  0  0  0  0  0  0  0  0  0  0  0  0  0  0  0  0  0  0  0  0  0   0  
0   0  0  0  0  0   0  0  0  0  0  0  0  0  0  0  0  0  0  0  0  0  0  0  0  0  0  0   0  
0   0  0  0  0  0   0  0  0  0  0  0  0  0  0  0  0  0  0  0  0  0  0  0  0  0  0  0   0
0   0  0  0  0  0   0  0  0  0  0  0  0  0  0  0  0  0  0  0  0  0  0  0  0  0  1  1   1
0   0  0  0  0  0   0  0  0  0  8  0  9  0  6  0  0  0  0  0  0  5  0  0  0  1  1  1   1
1   1  1  1  1  1   1  1  1  1  1  1  1  2  2  2  1  1  1  1  3  3  3  1  1  1  1  1   1